1111111111111111111111111
1000000000000000000000001
1030000000000000000000001
1000000000000000000000001
1000000000000000000000001
1000000000000000000000001
1000000000200000000000001
1000000000000000000000001
1000000000000000000000001
1000000000001000000000001
1000000000001000000000001
1000000000011100000000001
1000000001111111000000001
1000000000011100000000001
1000000000001000000000001
1000000000001000020000001
1000000000000000000000001
1000000000000000000000001
1000000000000000000000001
1000000000000000000000001
1000000000000000000000001
1000000000000000000000001
1000000000000000000000004
1000000000000000000000004
1111111111111111111111111