1111111111111111111111111
1000000100000000000000001
1030000100000000000000001
1000000100000000000000001
1000000100000000000000001
1000000100000000000000001
1000000100000000000000001
1000000100000000100000001
1000000100000000100000001
1000000100000000100000001
1000000100000000100000001
1000000100000000100000001
1000000100000000100000001
1000000100000000100000001
1000000100000000100000001
1000000100000000100000001
1000000000000000100000001
1000000000000000100000001
1000000000000000100000001
1000000000000000100000001
1000000000000000100000001
1000000000000000100000001
1000000000000000100000004
1000000000000000100000004
1111111111111111111111111